root	base
gam	gaccha
yam	yaccha
guh	gūhe
dhā	daha	dhe
dā	dajja
jā	jāya
jan	jāya
pā	piva
ḍaṃs	ḍasa
dhmā	dhama
vyadh	vadha
vadh	vadha
sad	sīda
thā	tiṭṭhā
is	iccha
vad	vajja	vajje	vada	vāde
mar	miya	miyya	mara
gah	gheppa
gam	ghamma	gaggha
jir	jiya	jiyya
dis	dakkha	daccha
das	dakkha	daccha